width=20
height=20
music=oak_lab
[render]
838,838,838,838,838,838,838,838,838,838,838,838,838,838,838,838,838,838,838,838,
838,838,838,838,838,838,838,838,838,838,838,838,838,838,838,838,838,838,838,838,
838,838,838,838,838,838,838,838,838,838,838,838,838,838,838,838,838,838,838,838,
838,838,838,914,914,914,914,838,838,838,838,838,838,838,838,838,838,838,838,838,
838,838,838,1147,1147,1147,1261,838,838,838,838,838,838,838,838,838,838,838,838,838,
838,838,859,1147,1147,1147,1147,838,838,838,838,838,838,838,838,838,838,838,838,838,
838,838,838,1147,1147,1147,1147,838,838,838,838,838,838,838,838,838,838,838,838,838,
838,838,838,838,838,838,838,838,838,838,838,838,838,838,838,838,838,838,838,838,
838,838,838,838,838,838,838,838,838,838,838,838,838,838,838,838,838,838,838,838,
838,838,838,838,838,838,838,838,838,838,838,838,838,838,838,838,838,838,838,838,
838,838,838,838,838,838,838,838,838,838,838,838,838,838,838,838,838,838,838,838,
838,838,838,838,838,838,838,838,838,838,838,838,838,838,838,838,838,838,838,838,
838,838,838,838,838,838,838,838,838,838,838,838,838,838,838,838,838,838,838,838,
838,838,838,838,838,838,1149,1149,1149,1149,1149,1149,1149,1149,838,838,838,838,838,838,
838,838,838,838,838,838,880,880,880,880,880,880,880,880,838,838,838,838,838,838,
838,838,838,838,838,838,1182,1182,1182,880,880,1182,1182,1182,838,838,838,838,838,838,
838,838,838,838,838,838,1220,1220,1220,1375,1376,1220,1220,1220,838,838,838,838,838,838,
838,838,838,838,838,838,880,880,880,880,880,880,880,880,838,838,838,838,838,838,
838,838,838,838,838,838,880,880,880,765,765,880,880,880,838,838,838,838,838,838,
838,838,838,838,838,838,838,838,838,838,838,838,838,838,838,838,838,838,838,838
[collision]
0,0,0,0,0,0,0,0,0,0,0,0,0,0,0,0,0,0,0,0,
0,0,0,0,0,0,0,0,0,0,0,0,0,0,0,0,0,0,0,0,
0,0,0,0,0,0,0,0,0,0,0,0,0,0,0,0,0,0,0,0,
0,0,1558,1558,1558,1558,1558,1558,0,0,0,0,0,0,0,0,0,0,0,0,
0,0,1558,0,0,0,0,1558,0,0,0,0,0,0,0,0,0,0,0,0,
0,0,1558,0,0,0,0,1558,0,0,0,0,0,0,0,0,0,0,0,0,
0,0,1558,0,0,0,0,1558,0,0,0,0,0,0,0,0,0,0,0,0,
0,0,1558,1558,1558,1558,1558,1558,0,0,0,0,0,0,0,0,0,0,0,0,
0,0,0,0,0,0,0,0,0,0,0,0,0,0,0,0,0,0,0,0,
0,0,0,0,0,0,0,0,0,0,0,0,0,0,0,0,0,0,0,0,
0,0,0,0,0,0,0,0,0,0,0,0,0,0,0,0,0,0,0,0,
0,0,0,0,0,0,0,0,0,0,0,0,0,0,0,0,0,0,0,0,
0,0,0,0,0,0,0,0,0,0,0,0,0,0,0,0,0,0,0,0,
0,0,0,0,0,1558,1558,1558,1558,1558,1558,1558,1558,1558,1558,0,0,0,0,0,
0,0,0,0,0,1558,0,0,0,0,0,0,0,0,1558,0,0,0,0,0,
0,0,0,0,0,1558,1558,1558,1558,0,0,1558,1558,1558,1558,0,0,0,0,0,
0,0,0,0,0,1558,1558,1558,1558,1558,1558,1558,1558,1558,1558,0,0,0,0,0,
0,0,0,0,0,1558,0,0,0,0,0,0,0,0,1558,0,0,0,0,0,
0,0,0,0,0,1558,0,0,0,0,0,0,0,0,1558,0,0,0,0,0,
0,0,0,0,0,1558,1558,1558,1558,0,0,1558,1558,1558,1558,0,0,0,0,0
[event]
0,0,0,0,0,0,0,0,0,0,0,0,0,0,0,0,0,0,0,0,
0,0,0,0,0,0,0,0,0,0,0,0,0,0,0,0,0,0,0,0,
0,0,0,0,0,0,0,0,0,0,0,0,0,0,0,0,0,0,0,0,
0,0,0,0,0,0,0,0,0,0,0,0,0,0,0,0,0,0,0,0,
0,0,0,0,0,0,1,0,0,0,0,0,0,0,0,0,0,0,0,0,
0,0,2,0,0,0,0,0,0,0,0,0,0,0,0,0,0,0,0,0,
0,0,0,0,0,0,0,0,0,0,0,0,0,0,0,0,0,0,0,0,
0,0,0,0,0,0,0,0,0,0,0,0,0,0,0,0,0,0,0,0,
0,0,0,0,0,0,0,0,0,0,0,0,0,0,0,0,0,0,0,0,
0,0,0,0,0,0,0,0,0,0,0,0,0,0,0,0,0,0,0,0,
0,0,0,0,0,0,0,0,0,0,0,0,0,0,0,0,0,0,0,0,
0,0,0,0,0,0,0,0,0,0,0,0,0,0,0,0,0,0,0,0,
0,0,0,0,0,0,0,0,0,0,0,0,0,0,0,0,0,0,0,0,
0,0,0,0,0,0,0,0,0,0,0,0,0,0,0,0,0,0,0,0,
0,0,0,0,0,0,0,0,0,0,0,0,0,0,0,0,0,0,0,0,
0,0,0,0,0,0,0,0,0,0,0,0,0,0,0,0,0,0,0,0,
0,0,0,0,0,0,0,0,0,3,3,0,0,0,0,0,0,0,0,0,
0,0,0,0,0,0,0,0,0,0,0,0,0,0,0,0,0,0,0,0,
0,0,0,0,0,0,0,0,0,0,0,0,0,0,0,0,0,0,0,0,
0,0,0,0,0,0,0,0,0,4,4,0,0,0,0,0,0,0,0,0

