width=27
height=24
music=pallet_town
[render]
40,40,40,39,39,39,45,39,39,39,39,39,7,40,40,7,39,39,39,39,39,45,39,40,40,40,40,
40,40,40,39,39,39,45,39,39,39,39,39,7,40,40,7,39,39,39,39,39,45,39,40,40,40,40,
40,40,40,39,39,39,7,39,39,39,39,39,7,40,40,7,39,39,39,39,39,7,39,40,40,40,40,
40,40,40,7,7,7,7,7,7,7,7,7,7,7,7,7,7,7,7,7,7,7,7,40,40,40,40,
40,40,40,7,39,2,1,2,1,2,1,2,1,2,1,2,1,2,1,2,1,39,7,40,40,40,40,
40,40,40,7,39,1,1,229,230,230,231,1,2,1,1,229,230,230,231,1,2,39,7,40,40,40,40,
40,40,40,7,39,3,3,497,498,500,501,2,1,3,3,497,498,500,501,2,1,39,7,40,40,40,40,
40,40,40,7,39,3,5,422,232,305,460,1,2,3,5,422,232,305,460,1,2,39,7,40,40,40,40,
40,40,40,7,39,2,1,2,1,2,1,2,1,2,1,2,1,2,1,2,1,39,7,40,40,40,40,
40,40,40,7,39,1,2,1,2,1,2,1,2,1,2,1,2,1,2,1,2,39,7,40,40,40,40,
40,40,40,7,39,2,1,3,3,3,3,1,1,343,344,344,344,344,345,1,1,39,7,40,40,40,40,
40,40,40,7,39,1,2,8,8,8,5,1,1,381,382,382,382,382,383,1,1,39,7,40,40,40,40,
40,40,40,7,39,2,1,12,12,12,12,1,1,419,420,349,350,351,421,1,1,39,7,40,40,40,40,
40,40,40,7,39,1,2,50,50,50,50,1,1,457,305,232,305,305,459,1,1,39,7,40,40,40,40,
40,40,40,7,39,2,1,2,1,1,1,1,1,3,3,3,3,3,3,3,3,39,7,40,40,40,40,
40,40,40,7,39,1,2,1,1,1,1,1,1,8,8,8,5,8,8,3,3,39,7,40,40,40,40,
40,40,40,7,39,39,39,11,86,86,9,3,3,12,12,12,12,12,12,3,3,39,7,40,40,40,40,
40,40,40,7,39,39,39,49,48,48,47,3,3,50,50,50,50,50,50,3,3,39,7,40,40,40,40,
40,40,40,7,39,39,39,49,48,48,47,3,3,3,3,3,3,3,3,3,3,39,7,40,40,40,40,
40,40,40,7,7,39,39,49,48,48,47,7,7,7,7,7,7,7,7,7,7,7,7,40,40,40,40,
40,40,40,7,7,7,7,49,48,48,47,7,7,7,7,7,7,7,7,7,7,7,7,40,40,40,40,
40,40,40,39,39,39,7,49,48,48,47,39,39,39,39,39,39,7,39,39,39,39,39,40,40,40,40,
40,40,40,39,39,39,7,49,48,48,47,39,39,12,12,12,12,7,39,39,39,39,39,40,40,40,40,
40,40,40,39,39,39,7,49,48,48,47,39,39,50,50,50,50,7,39,39,39,39,39,40,40,40,40
[collision]
0,0,0,0,0,0,1558,0,0,0,0,0,1558,0,0,1558,0,0,0,0,0,1558,0,0,0,0,0,
0,0,0,0,0,0,1558,0,0,0,0,0,1558,0,0,1558,0,0,0,0,0,1558,0,0,0,0,0,
0,0,0,0,0,0,1558,0,0,0,0,0,1558,0,0,1558,0,0,0,0,0,1558,0,0,0,0,0,
0,0,0,1558,1558,1558,1558,1558,1558,1558,1558,1558,1558,1558,1558,1558,1558,1558,1558,1558,1558,1558,1558,0,0,0,0,
0,0,0,1558,0,0,0,0,0,0,0,0,0,0,0,0,0,0,0,0,0,0,1558,0,0,0,0,
0,0,0,1558,0,0,0,1558,1558,1558,1558,0,0,0,0,1558,1558,1558,1558,0,0,0,1558,0,0,0,0,
0,0,0,1558,0,0,0,1558,1558,1558,1558,0,0,0,0,1558,1558,1558,1558,0,0,0,1558,0,0,0,0,
0,0,0,1558,0,0,1558,1558,0,1558,1558,0,0,0,1558,1558,0,1558,1558,0,0,0,1558,0,0,0,0,
0,0,0,1558,0,0,0,0,0,0,0,0,0,0,0,0,0,0,0,0,0,0,1558,0,0,0,0,
0,0,0,1558,0,0,0,0,0,0,0,0,0,0,0,0,0,0,0,0,0,0,1558,0,0,0,0,
0,0,0,1558,0,0,0,0,0,0,0,0,0,1558,1558,1558,1558,1558,1558,0,0,0,1558,0,0,0,0,
0,0,0,1558,0,0,0,1558,1558,1558,1558,0,0,1558,1558,1558,1558,1558,1558,0,0,0,1558,0,0,0,0,
0,0,0,1558,0,0,0,0,0,0,0,0,0,1558,1558,1558,1558,1558,1558,0,0,0,1558,0,0,0,0,
0,0,0,1558,0,0,0,0,0,0,0,0,0,1558,1558,0,1558,1558,1558,0,0,0,1558,0,0,0,0,
0,0,0,1558,0,0,0,0,0,0,0,0,0,0,0,0,0,0,0,0,0,0,1558,0,0,0,0,
0,0,0,1558,0,0,0,0,0,0,0,0,0,1558,1558,1558,1558,1558,1558,0,0,0,1558,0,0,0,0,
0,0,0,1558,0,0,0,1558,1558,1558,1558,0,0,0,0,0,0,0,0,0,0,0,1558,0,0,0,0,
0,0,0,1558,0,0,0,1558,1558,1558,1558,0,0,0,0,0,0,0,0,0,0,0,1558,0,0,0,0,
0,0,0,1558,0,0,0,1558,1558,1558,1558,0,0,0,0,0,0,0,0,0,0,0,1558,0,0,0,0,
0,0,0,1558,1558,0,0,1558,1558,1558,1558,1558,1558,1558,1558,1558,1558,1558,1558,1558,1558,1558,1558,0,0,0,0,
0,0,0,1558,1558,1558,1558,0,0,0,0,1558,1558,1558,1558,1558,1558,1558,1558,1558,1558,1558,1558,0,0,0,0,
0,0,0,0,0,0,1558,0,0,0,0,0,0,0,0,0,0,1558,0,0,0,0,0,0,0,0,0,
0,0,0,0,0,0,1558,0,0,0,0,0,0,0,0,0,0,1558,0,0,0,0,0,0,0,0,0,
0,0,0,0,0,0,1558,0,0,0,0,0,0,0,0,0,0,1558,0,0,0,0,0,0,0,0,0
[event]
0,0,0,0,0,0,0,0,0,0,0,0,0,0,0,0,0,0,0,0,0,0,0,0,0,0,0,
0,0,0,0,0,0,0,0,0,0,0,0,0,0,0,0,0,0,0,0,0,0,0,0,0,0,0,
0,0,0,0,0,0,0,0,0,0,0,0,0,0,0,0,0,0,0,0,0,0,0,0,0,0,0,
0,0,0,0,0,0,0,0,0,0,0,0,0,0,0,0,0,0,0,0,0,0,0,0,0,0,0,
0,0,0,0,0,0,0,0,0,0,0,0,0,0,0,0,0,0,0,0,0,0,0,0,0,0,0,
0,0,0,0,0,0,0,0,0,0,0,0,0,0,0,0,0,0,0,0,0,0,0,0,0,0,0,
0,0,0,0,0,0,0,0,0,0,0,0,0,0,0,0,0,0,0,0,0,0,0,0,0,0,0,
0,0,0,0,0,0,1,0,2,0,0,0,0,0,3,0,4,0,0,0,0,0,0,0,0,0,0,
0,0,0,0,0,0,0,0,0,0,0,0,0,0,0,0,0,0,0,0,0,0,0,0,0,0,0,
0,0,0,0,0,0,0,0,0,0,0,0,0,0,0,0,0,0,0,0,0,0,0,0,0,0,0,
0,0,0,0,0,8,0,0,0,0,0,0,0,0,0,0,0,0,0,0,0,0,0,0,0,0,0,
0,0,0,0,0,0,0,0,0,0,5,0,0,0,0,0,0,0,0,0,0,0,0,0,0,0,0,
0,0,0,0,0,0,0,0,0,0,0,0,0,0,0,0,0,0,0,0,0,0,0,0,0,0,0,
0,0,0,0,0,0,0,0,0,0,0,0,0,0,0,6,0,0,0,0,0,0,0,0,0,0,0,
0,0,0,0,0,0,0,0,0,0,0,0,0,0,0,0,0,0,0,0,0,0,0,0,0,0,0,
0,0,0,0,0,0,0,0,0,0,0,0,0,0,0,0,7,0,0,0,0,0,0,0,0,0,0,
0,0,0,0,0,0,0,0,0,0,0,0,0,0,0,0,9,0,0,0,0,0,0,0,0,0,0,
0,0,0,0,0,0,0,0,0,0,0,0,0,0,0,0,0,0,0,0,0,0,0,0,0,0,0,
0,0,0,0,0,0,0,0,0,0,0,0,0,0,0,0,0,0,0,0,0,0,0,0,0,0,0,
0,0,0,0,0,0,0,0,0,0,0,0,0,0,0,0,0,0,0,0,0,0,0,0,0,0,0,
0,0,0,0,0,0,0,0,0,0,0,0,0,0,0,0,0,0,0,0,0,0,0,0,0,0,0,
0,0,0,0,0,0,0,0,0,0,0,0,0,0,0,0,0,0,0,0,0,0,0,0,0,0,0,
0,0,0,0,0,0,0,0,0,0,0,0,0,0,0,0,0,0,0,0,0,0,0,0,0,0,0,
0,0,0,0,0,0,0,0,0,0,0,0,0,0,0,0,0,0,0,0,0,0,0,0,0,0,0

