width=20
height=20
music=pallet_town
[render]
1111,1111,1111,1111,1111,1111,1111,1111,1111,1111,1111,1111,1111,1111,1111,1111,1111,1111,1111,1111,
1111,1111,1111,1111,1111,1111,1111,1111,1111,1111,1111,1111,1111,1111,1111,1111,1111,1111,1111,1111,
1111,1111,1111,1111,1111,1111,1111,1111,1111,1111,1111,1111,1111,1111,1111,1111,1111,1111,1111,1111,
1111,1111,1111,1111,1111,838,838,838,838,838,838,838,1111,1111,1111,1111,1111,1111,1111,1111,
1111,1111,838,838,838,838,838,838,838,838,838,838,838,838,838,838,838,1111,1111,1111,
1111,1111,838,838,838,838,838,838,838,838,838,838,838,838,838,838,838,1111,1111,1111,
838,838,838,838,838,838,838,1068,615,616,617,618,615,1068,838,838,838,1111,1111,1111,
838,838,838,838,838,615,615,1106,647,654,655,656,621,1106,615,615,838,838,838,838,
838,838,838,838,615,1181,647,647,647,647,647,647,647,647,647,1181,615,838,838,838,
838,838,838,838,1181,1219,647,647,647,647,647,647,647,647,647,1219,1181,838,838,838,
1111,838,838,615,1219,647,647,647,647,691,691,691,647,647,647,647,1219,615,838,838,
1111,838,838,838,838,838,838,838,838,838,838,838,838,838,838,838,838,838,838,838,
1111,838,838,838,838,838,838,838,838,838,838,838,838,838,838,838,838,838,838,838,
1111,838,838,838,838,838,838,838,838,838,838,838,838,838,838,838,838,838,838,838,
1111,838,838,1111,1111,1111,1111,1111,838,838,838,838,1111,838,838,838,838,1111,1111,1111,
1111,1111,838,838,838,838,838,838,1111,1111,838,838,838,1111,1111,1111,1111,1111,1111,1111,
838,838,838,838,838,838,838,838,838,838,838,1111,1111,1111,1111,1111,1111,1111,1111,1111,
1111,1111,1111,1111,1111,1111,1111,1111,1111,1111,1111,1111,1111,1111,1111,1111,1111,1111,1111,1111,
1111,1111,1111,1111,1111,1111,1111,1111,1111,1111,1111,1111,1111,1111,1111,1111,1111,1111,1111,1111,
1111,1111,1111,1111,1111,1111,1111,1111,1111,1111,1111,1111,1111,1111,1111,1111,1111,1111,1111,1111
[collision]
0,0,0,0,0,0,0,0,0,0,0,0,0,0,0,0,0,0,0,0,
0,0,0,0,0,0,0,0,0,0,0,0,0,0,0,0,0,0,0,0,
0,0,0,0,0,0,0,0,0,0,0,0,0,0,0,0,0,0,0,0,
0,0,0,0,0,0,0,0,0,0,0,0,0,0,0,0,0,0,0,0,
0,0,0,0,0,0,0,0,0,0,0,0,0,0,0,0,0,0,0,0,
0,0,0,0,0,0,0,1558,1558,1558,1558,1558,1558,1558,0,0,0,0,0,0,
0,0,0,0,0,1558,1558,1558,1558,1558,1558,1558,1558,1558,1558,1558,0,0,0,0,
0,0,0,0,1558,1558,1558,1558,0,0,0,0,0,1558,1558,1558,1558,0,0,0,
0,0,0,1558,1558,1558,0,0,0,0,0,0,0,0,0,1558,1558,1558,0,0,
0,0,0,1558,1558,1558,0,0,0,0,0,0,0,0,0,1558,1558,1558,0,0,
0,0,1558,1558,1558,0,0,0,0,0,0,0,0,0,0,0,1558,1558,1558,0,
0,0,0,1558,1558,1558,1558,1558,1558,0,0,0,1558,1558,1558,1558,1558,1558,0,0,
0,0,0,0,0,0,0,0,0,0,0,0,0,0,0,0,0,0,0,0,
0,0,0,0,0,0,0,0,0,0,0,0,0,0,0,0,0,0,0,0,
0,0,0,0,0,0,0,0,0,0,0,0,0,0,0,0,0,0,0,0,
0,0,0,0,0,0,0,0,0,0,0,0,0,0,0,0,0,0,0,0,
0,0,0,0,0,0,0,0,0,0,0,0,0,0,0,0,0,0,0,0,
0,0,0,0,0,0,0,0,0,0,0,0,0,0,0,0,0,0,0,0,
0,0,0,0,0,0,0,0,0,0,0,0,0,0,0,0,0,0,0,0,
0,0,0,0,0,0,0,0,0,0,0,0,0,0,0,0,0,0,0,0
[event]
0,0,0,0,0,0,0,0,0,0,0,0,0,0,0,0,0,0,0,0,
0,0,0,0,0,0,0,0,0,0,0,0,0,0,0,0,0,0,0,0,
0,0,0,0,0,0,0,0,0,0,0,0,0,0,0,0,0,0,0,0,
0,0,0,0,0,0,0,0,0,0,0,0,0,0,0,0,0,0,0,0,
0,0,0,0,0,0,0,0,0,0,0,0,0,0,0,0,0,0,0,0,
0,0,0,0,0,0,0,0,0,0,0,0,0,0,0,0,0,0,0,0,
0,0,0,0,0,0,0,0,0,0,0,0,0,0,0,0,0,0,0,0,
0,0,0,0,0,0,0,0,0,0,1,0,2,0,0,0,0,0,0,0,
0,0,0,0,0,0,0,0,0,0,0,0,0,0,0,0,0,0,0,0,
0,0,0,0,0,0,0,0,0,0,0,0,0,0,0,0,0,0,0,0,
0,0,0,0,0,0,0,0,0,0,0,0,0,0,0,0,0,0,0,0,
0,0,0,0,0,0,0,0,0,3,3,3,0,0,0,0,0,0,0,0,
0,0,0,0,0,0,0,0,0,0,0,0,0,0,0,0,0,0,0,0,
0,0,0,0,0,0,0,0,0,0,0,0,0,0,0,0,0,0,0,0,
0,0,0,0,0,0,0,0,0,0,0,0,0,0,0,0,0,0,0,0,
0,0,0,0,0,0,0,0,0,0,0,0,0,0,0,0,0,0,0,0,
0,0,0,0,0,0,0,0,0,0,0,0,0,0,0,0,0,0,0,0,
0,0,0,0,0,0,0,0,0,0,0,0,0,0,0,0,0,0,0,0,
0,0,0,0,0,0,0,0,0,0,0,0,0,0,0,0,0,0,0,0,
0,0,0,0,0,0,0,0,0,0,0,0,0,0,0,0,0,0,0,0