width=20
height=20
music=pallet_town
[render]
1111,1111,1111,1111,1111,1111,1111,1111,1111,1111,1111,1111,1111,1111,1111,1111,1111,1111,1111,1111,
1111,1111,1111,1111,1111,1111,1111,1111,1111,1111,1111,1111,1111,1111,1111,1111,1111,1111,1111,1111,
1111,1111,1111,1111,1111,1111,1111,1111,1111,1111,1111,1111,1111,1111,1111,1111,1111,1111,1111,1111,
1111,1111,1111,1111,1111,1111,1111,1111,1111,1111,1111,1111,1111,1111,1111,1111,1111,1111,1111,1111,
1111,1111,1111,1111,609,609,659,609,609,609,609,609,659,609,609,609,609,1111,1111,1111,
1111,1111,1111,1111,843,1298,1299,1300,647,647,647,647,647,647,647,610,611,1111,1111,1111,
1111,1111,1111,1111,843,1336,1337,1338,647,647,657,738,739,657,647,648,649,1111,1111,1111,
1111,1111,1111,1111,744,745,647,647,647,647,657,776,777,657,647,647,647,1111,1111,1111,
1111,1111,1111,1111,782,647,647,647,647,647,647,647,647,647,647,647,647,1111,1111,1111,
1111,1111,1111,1111,647,647,647,647,647,647,647,647,647,647,647,647,647,1111,1111,1111,
1111,1111,1111,1111,647,691,691,647,15,90,90,90,90,90,90,90,90,1111,1111,1111,
1111,1111,1111,1111,1111,1111,1111,1111,53,1457,1458,1459,1460,1461,1462,1463,1464,1111,1111,1111,
1111,1111,1111,1111,1111,1111,1111,1111,53,1495,1496,1497,1498,1499,1500,1501,1502,1111,1111,1111,
1111,1111,1111,1111,1111,1111,1111,1111,53,1533,1534,1535,1536,1537,1538,1539,1540,1111,1111,1111,
1111,1111,1111,1111,1111,1111,1111,1111,1111,1111,1111,1111,1111,1111,1111,1111,1111,1111,1111,1111,
1111,1111,1111,1111,1111,1111,1111,1111,1111,1111,1111,1111,1111,1111,1111,1111,1111,1111,1111,1111,
1111,1111,1111,1111,1111,1111,1111,1111,1111,1111,1111,1111,1111,1111,1111,1111,1111,1111,1111,1111,
1111,1111,1111,1111,1111,1111,1111,1111,1111,1111,1111,1111,1111,1111,1111,1111,1111,1111,1111,1111,
1111,1111,1111,1111,1111,1111,1111,1111,1111,1111,1111,1111,1111,1111,1111,1111,1111,1111,1111,1111,
1111,1111,1111,1111,1111,1111,1111,1111,1111,1111,1111,1111,1111,1111,1111,1111,1111,1111,1111,1111
[collision]
0,0,0,0,0,0,0,0,0,0,0,0,0,0,0,0,0,0,0,0,
0,0,0,0,0,0,0,0,0,0,0,0,0,0,0,0,0,0,0,0,
0,0,0,0,0,0,0,0,0,0,0,0,0,0,0,0,0,0,0,0,
0,0,0,0,0,0,0,0,0,0,0,0,0,0,0,0,0,0,0,0,
0,0,0,1558,1558,1558,1558,1558,1558,1558,1558,1558,1558,1558,1558,1558,1558,1558,0,0,
0,0,0,1558,1558,1558,1558,1558,0,0,0,0,0,0,0,1558,1558,1558,0,0,
0,0,0,1558,1558,1558,1558,1558,0,0,0,1558,1558,0,0,0,0,1558,0,0,
0,0,0,1558,1558,0,0,0,0,0,0,1558,1558,0,0,0,0,1558,0,0,
0,0,0,1558,1558,0,0,0,0,0,0,0,0,0,0,0,0,1558,0,0,
0,0,0,1558,0,0,0,0,0,0,0,0,0,0,0,0,0,1558,0,0,
0,0,0,1558,0,0,0,0,1558,1558,1558,1558,1558,1558,1558,1558,1558,1558,0,0,
0,0,0,1558,1558,0,0,1558,1558,0,0,0,0,0,0,0,0,1558,0,0,
0,0,0,0,0,0,0,1558,0,0,0,0,0,0,0,0,0,1558,0,0,
0,0,0,0,0,0,0,1558,0,0,0,0,0,0,0,0,0,1558,0,0,
0,0,0,0,0,0,0,1558,1558,1558,1558,1558,1558,1558,1558,1558,1558,1558,0,0,
0,0,0,0,0,0,0,0,0,0,0,0,0,0,0,0,0,0,0,0,
0,0,0,0,0,0,0,0,0,0,0,0,0,0,0,0,0,0,0,0,
0,0,0,0,0,0,0,0,0,0,0,0,0,0,0,0,0,0,0,0,
0,0,0,0,0,0,0,0,0,0,0,0,0,0,0,0,0,0,0,0,
0,0,0,0,0,0,0,0,0,0,0,0,0,0,0,0,0,0,0,0
[event]
0,0,0,0,0,0,0,0,0,0,0,0,0,0,0,0,0,0,0,0,
0,0,0,0,0,0,0,0,0,0,0,0,0,0,0,0,0,0,0,0,
0,0,0,0,0,0,0,0,0,0,0,0,0,0,0,0,0,0,0,0,
0,0,0,0,0,0,0,0,0,0,0,0,0,0,0,0,0,0,0,0,
0,0,0,0,0,0,0,0,0,0,0,0,0,0,0,0,0,0,0,0,
0,0,0,0,0,0,0,0,0,0,0,0,0,0,0,0,1,0,0,0,
0,0,0,0,0,0,0,0,0,0,0,0,0,0,0,0,0,0,0,0,
0,0,0,0,2,0,0,0,0,0,0,0,0,0,0,0,0,0,0,0,
0,0,0,0,0,0,0,0,0,0,0,0,0,0,0,0,0,0,0,0,
0,0,0,0,0,0,0,0,0,0,0,0,0,0,0,0,0,0,0,0,
0,0,0,0,0,0,0,0,0,0,0,0,0,0,0,0,0,0,0,0,
0,0,0,0,0,3,3,0,0,0,0,0,0,0,0,0,0,0,0,0,
0,0,0,0,0,0,0,0,0,0,0,0,0,0,0,0,0,0,0,0,
0,0,0,0,0,0,0,0,0,0,0,0,0,0,0,0,0,0,0,0,
0,0,0,0,0,0,0,0,0,0,0,0,0,0,0,0,0,0,0,0,
0,0,0,0,0,0,0,0,0,0,0,0,0,0,0,0,0,0,0,0,
0,0,0,0,0,0,0,0,0,0,0,0,0,0,0,0,0,0,0,0,
0,0,0,0,0,0,0,0,0,0,0,0,0,0,0,0,0,0,0,0,
0,0,0,0,0,0,0,0,0,0,0,0,0,0,0,0,0,0,0,0,
0,0,0,0,0,0,0,0,0,0,0,0,0,0,0,0,0,0,0,0

